111111
100100
100001
100001
1P0011
111111