1111111111111
1001000000011
100001E111001
1P00110000001
1111111111111