1111111111111
10010000000C1
100001111P001
1100110000001
1111111111111