1111111111111
10010000000C1
100CA11111001
1P0011E000001
1111111111111