1111111111111
10010000001C1
1000010001001
1P0011E010001
1111111111111
