111111
1000C1
111101
1P1E01
111111
