111111
1001C1
100001
10E001
1P0011
111111