111111
1000C1
101101
1P1E01
111111
